"filename", "language", "Makefile", "C++", "Markdown", "HTML", "comment", "blank", "total"
"/home/toxic/Codes/VsCode/HttpServer/Makefile", "Makefile", 45, 0, 0, 0, 27, 20, 92
"/home/toxic/Codes/VsCode/HttpServer/README.md", "Markdown", 0, 0, 86, 0, 0, 20, 106
"/home/toxic/Codes/VsCode/HttpServer/WebHome/index.html", "HTML", 0, 0, 0, 120, 1, 19, 140
"/home/toxic/Codes/VsCode/HttpServer/include/Epoll.hpp", "C++", 0, 33, 0, 0, 25, 4, 62
"/home/toxic/Codes/VsCode/HttpServer/include/Header.hpp", "C++", 0, 15, 0, 0, 14, 2, 31
"/home/toxic/Codes/VsCode/HttpServer/include/Request.hpp", "C++", 0, 40, 0, 0, 20, 5, 65
"/home/toxic/Codes/VsCode/HttpServer/include/Response.hpp", "C++", 0, 35, 0, 0, 27, 3, 65
"/home/toxic/Codes/VsCode/HttpServer/include/Router.hpp", "C++", 0, 19, 0, 0, 11, 3, 33
"/home/toxic/Codes/VsCode/HttpServer/include/Server.hpp", "C++", 0, 28, 0, 0, 14, 3, 45
"/home/toxic/Codes/VsCode/HttpServer/include/Setting.hpp", "C++", 0, 12, 0, 0, 9, 2, 23
"/home/toxic/Codes/VsCode/HttpServer/include/Socket.hpp", "C++", 0, 29, 0, 0, 15, 5, 49
"/home/toxic/Codes/VsCode/HttpServer/include/TException.hpp", "C++", 0, 11, 0, 0, 9, 2, 22
"/home/toxic/Codes/VsCode/HttpServer/include/Task.hpp", "C++", 0, 33, 0, 0, 24, 4, 61
"/home/toxic/Codes/VsCode/HttpServer/include/TaskThreadPool.hpp", "C++", 0, 29, 0, 0, 24, 3, 56
"/home/toxic/Codes/VsCode/HttpServer/include/Utils/FileUtil.hpp", "C++", 0, 45, 0, 0, 21, 6, 72
"/home/toxic/Codes/VsCode/HttpServer/include/Utils/LogBuffer.hpp", "C++", 0, 36, 0, 0, 14, 5, 55
"/home/toxic/Codes/VsCode/HttpServer/include/Utils/LogThreadPool.hpp", "C++", 0, 32, 0, 0, 22, 6, 60
"/home/toxic/Codes/VsCode/HttpServer/include/Utils/TimeUtil.hpp", "C++", 0, 0, 0, 0, 8, 1, 9
"/home/toxic/Codes/VsCode/HttpServer/src/Epoll.cpp", "C++", 0, 122, 0, 0, 78, 13, 213
"/home/toxic/Codes/VsCode/HttpServer/src/FileUtil.cpp", "C++", 0, 174, 0, 0, 80, 21, 275
"/home/toxic/Codes/VsCode/HttpServer/src/Header.cpp", "C++", 0, 33, 0, 0, 31, 6, 70
"/home/toxic/Codes/VsCode/HttpServer/src/LogBuffer.cpp", "C++", 0, 71, 0, 0, 27, 15, 113
"/home/toxic/Codes/VsCode/HttpServer/src/LogThreadPool.cpp", "C++", 0, 132, 0, 0, 41, 9, 182
"/home/toxic/Codes/VsCode/HttpServer/src/Request.cpp", "C++", 0, 213, 0, 0, 90, 19, 322
"/home/toxic/Codes/VsCode/HttpServer/src/Response.cpp", "C++", 0, 220, 0, 0, 66, 14, 300
"/home/toxic/Codes/VsCode/HttpServer/src/Router.cpp", "C++", 0, 41, 0, 0, 27, 5, 73
"/home/toxic/Codes/VsCode/HttpServer/src/Server.cpp", "C++", 0, 86, 0, 0, 38, 10, 134
"/home/toxic/Codes/VsCode/HttpServer/src/Setting.cpp", "C++", 0, 22, 0, 0, 21, 7, 50
"/home/toxic/Codes/VsCode/HttpServer/src/Socket.cpp", "C++", 0, 75, 0, 0, 38, 13, 126
"/home/toxic/Codes/VsCode/HttpServer/src/TException.cpp", "C++", 0, 12, 0, 0, 8, 4, 24
"/home/toxic/Codes/VsCode/HttpServer/src/Task.cpp", "C++", 0, 67, 0, 0, 40, 9, 116
"/home/toxic/Codes/VsCode/HttpServer/src/TaskThreadPool.cpp", "C++", 0, 103, 0, 0, 36, 9, 148
"/home/toxic/Codes/VsCode/HttpServer/src/TimeUtil.cpp", "C++", 0, 0, 0, 0, 8, 1, 9
"/home/toxic/Codes/VsCode/HttpServer/src/main.cpp", "C++", 0, 20, 0, 0, 8, 3, 31
"/home/toxic/Codes/VsCode/HttpServer/test/default.cpp", "C++", 0, 12, 0, 0, 9, 4, 25
"/home/toxic/Codes/VsCode/HttpServer/test/log.cpp", "C++", 0, 27, 0, 0, 9, 7, 43
"/home/toxic/Codes/VsCode/HttpServer/test/router.cpp", "C++", 0, 20, 0, 0, 9, 7, 36
"Total", "-", 45, 1847, 86, 120, 949, 289, 3336